City/Town,Ward,Pct,"Dennis Carver","Karen Kerin",Write-Ins,Blanks,"Total Votes Cast"
,,,,
Addison,,,77,52,4,0,133
Albany,,,46,12,4,0,62
Alburgh,,,73,25,9,0,107
Andover,,,23,13,0,0,36
Arlington,,,74,42,2,0,118
Athens,,,7,4,0,0,11
Bakersfield,,,42,13,2,0,57
Baltimore,,,8,6,0,0,14
Barnard,,,26,26,0,0,52
Barnet,,,77,26,3,0,106
"Barre City",-,"Washington 3-1",181,76,16,0,273
"Barre City",-,"Washington 3-2",143,48,14,0,205
"Barre City",-,"Washington 3-3",20,11,3,0,34
"Barre Town",,,441,157,84,0,682
Barton,,,93,33,29,0,155
Belvidere,,,11,10,2,0,23
Bennington,-,"Bennington 2-1",112,69,5,0,186
Bennington,-,"Bennington 2-1 Nb",14,16,1,0,31
Bennington,-,"Bennington 2-2",125,69,2,0,196
Bennington,-,"Bennington 5",5,4,0,0,9
Benson,,,21,14,1,0,36
Berkshire,,,38,15,3,0,56
Berlin,,,100,38,8,0,146
Bethel,,,60,33,5,0,98
Bloomfield,,,7,1,0,0,8
Bolton,,,34,22,2,0,58
Bradford,,,103,41,4,0,148
Braintree,,,39,42,3,0,84
Brandon,,,130,114,4,0,248
Brattleboro,-,"Windham 3-1",40,39,4,0,83
Brattleboro,-,"Windham 3-2",42,17,4,0,63
Brattleboro,-,"Windham 3-3",36,23,2,0,61
Bridgewater,,,30,23,5,0,58
Bridport,,,107,25,6,0,138
Brighton,,,67,34,28,0,129
Bristol,,,127,66,8,0,201
Brookfield,,,56,34,3,0,93
Brookline,,,9,9,0,0,18
Brownington,,,24,9,0,0,33
Brunswick,,,10,1,0,0,11
Burke,,,61,22,2,0,85
Burlington,-,"Chittenden 3-1",292,110,7,0,409
Burlington,-,"Chittenden 3-2",121,57,12,0,190
Burlington,-,"Chittenden 3-3",69,31,6,0,106
Burlington,-,"Chittenden 3-4",45,36,8,0,89
Burlington,-,"Chittenden 3-5",189,67,11,0,267
Burlington,-,"Chittenden 3-6",15,6,0,0,21
Cabot,,,32,22,3,0,57
Calais,,,70,29,2,0,101
Cambridge,,,85,34,13,0,132
Canaan,,,33,17,1,0,51
Castleton,,,91,60,3,0,154
Cavendish,,,47,24,2,0,73
Charleston,,,30,9,2,0,41
Charlotte,,,116,50,4,0,170
Chelsea,,,81,40,2,0,123
Chester,,,81,55,2,0,138
Chittenden,,,43,17,1,0,61
Clarendon,,,62,54,2,0,118
Colchester,-,"Chittenden 7-1",187,75,2,0,264
Colchester,-,"Chittenden 7-2",295,110,5,0,410
Concord,,,34,12,2,0,48
Corinth,,,39,25,1,0,65
Cornwall,,,44,15,2,0,61
Coventry,,,38,21,6,0,65
Craftsbury,,,42,17,10,0,69
Danby,,,78,57,3,0,138
Danville,,,140,20,11,0,171
Derby,,,112,52,36,0,200
Dorset,,,60,43,0,0,103
Dover,,,36,21,1,0,58
Dummerston,,,30,8,0,0,38
Duxbury,,,48,19,3,0,70
"E. Haven",,,22,15,1,0,38
"E. Montpelier",,,114,71,14,0,199
Eden,,,32,20,3,0,55
Elmore,,,25,3,4,0,32
Enosburgh,,,56,18,2,0,76
Essex,-,"Chittenden 6-1",250,97,6,0,353
Essex,-,"Chittenden 6-2",251,117,11,0,379
Essex,-,"Chittenden 6-3",74,33,4,0,111
"Fair Haven",,,52,29,1,0,82
Fairfax,,,101,49,6,0,156
Fairfield,,,31,9,12,0,52
Fairlee,,,30,20,1,0,51
Fayston,,,29,10,0,0,39
Ferrisburgh,,,167,1,1,0,169
Fletcher,,,32,13,0,0,45
Franklin,,,57,26,1,0,84
Georgia,,,135,53,11,0,199
Glover,,,43,19,13,0,75
Goshen,,,6,16,1,0,23
Grafton,,,16,10,1,0,27
Granby,,,12,2,0,0,14
"Grand Isle",,,95,35,25,0,155
Granville,,,6,5,0,0,11
Greensboro,,,33,12,3,0,48
Groton,,,54,18,4,0,76
Guildhall,,,23,11,0,0,34
Guilford,,,33,12,3,0,48
Halifax,,,21,4,0,0,25
Hancock,,,9,5,5,0,19
Hardwick,,,82,17,15,0,114
Hartford,-,"Windsor 6-1",29,30,1,0,60
Hartford,-,"Windsor 6-2",87,88,2,0,177
Hartland,,,77,60,5,0,142
Highgate,,,54,21,24,0,99
Hinesburg,-,"Chittenden 1-1",81,44,4,0,129
Hinesburg,-,"Chittenden 1-2",4,0,0,0,4
Holland,,,21,8,3,0,32
Hubbardton,,,18,7,2,0,27
Huntington,,,49,20,1,0,70
"Hyde Park",,,97,31,8,0,136
Ira,-,"Rutland Rutland 1-1",1,1,0,0,2
Ira,-,"Rutland Rutland 1-2",11,8,0,0,19
Irasburg,,,27,13,10,0,50
"Isle La Motte",,,30,14,1,0,45
Jamaica,,,15,20,2,0,37
Jay,,,18,4,7,0,29
Jericho,,,204,73,3,0,280
Johnson,,,48,27,5,0,80
Killington,,,23,21,6,0,50
Kirby,,,16,8,1,0,25
Landgrove,,,5,9,0,0,14
Leicester,,,23,43,2,0,68
Lemington,,,5,3,0,0,8
Lincoln,,,45,31,9,0,85
Londonderry,,,41,16,0,0,57
Lowell,,,19,7,5,0,31
Ludlow,,,50,27,2,0,79
Lunenburg,,,59,24,5,0,88
Lyndon,,,173,42,8,0,223
Maidstone,,,11,6,0,0,17
Manchester,,,142,46,0,0,188
Marlboro,,,20,10,1,0,31
Marshfield,,,48,29,7,0,84
Mendon,,,53,29,3,0,85
Middlebury,,,157,79,10,0,246
Middlesex,,,58,32,6,0,96
"Middletown Springs",,,26,16,1,0,43
Milton,-,"Chittenden 9",224,79,8,0,311
Milton,-,"Grand Isle-Chittenden 1-1",44,16,0,0,60
Monkton,,,62,30,1,0,93
Montgomery,,,24,15,2,0,41
Montpelier,,,286,105,15,0,406
Moretown,,,82,15,3,0,100
Morgan,,,51,11,2,0,64
Morristown,,,136,56,11,0,203
"Mount Holly",,,49,29,0,0,78
"Mount Tabor",,,5,4,0,0,9
"New Haven",,,77,37,1,0,115
Newark,,,25,13,1,0,39
Newbury,-,"Center Town House",52,24,1,0,77
Newbury,-,"Town Office",22,11,0,0,33
Newbury,-,"West River Village",22,9,2,0,33
Newfane,,,34,19,1,0,54
"Newport City",,,162,73,18,0,253
"Newport Town",,,59,25,6,0,90
"N. Hero",,,40,20,8,0,68
Northfield,,,190,94,13,0,297
Norton,,,9,8,0,0,17
Norwich,,,29,35,0,0,64
Orange,,,72,30,6,0,108
Orwell,,,61,21,15,0,97
Panton,,,36,13,1,0,50
Pawlet,,,27,24,2,0,53
Peacham,,,39,13,1,0,53
Peru,,,18,7,2,0,27
Pittsfield,,,31,22,1,0,54
Pittsford,,,66,55,5,0,126
Plainfield,,,46,17,3,0,66
Plymouth,,,15,11,0,0,26
Pomfret,,,17,23,4,0,44
Poultney,,,130,90,4,0,224
Pownal,,,77,31,3,0,111
Proctor,,,49,25,3,0,77
Putney,,,31,7,0,0,38
Randolph,,,215,143,11,0,369
Reading,,,15,12,0,0,27
Readsboro,,,15,14,0,0,29
Richford,,,51,24,3,0,78
Richmond,,,140,54,3,0,197
Ripton,,,7,5,1,0,13
Rochester,,,33,33,4,0,70
Rockingham,,,54,46,6,0,106
Roxbury,,,23,9,1,0,33
Royalton,,,66,35,1,0,102
Rupert,,,24,6,0,0,30
"Rutland City",-,"Rutland 5-1",123,73,1,0,197
"Rutland City",-,"Rutland 5-2",101,62,3,0,166
"Rutland City",-,"Rutland 5-3",32,32,1,0,65
"Rutland City",-,"Rutland 5-4",86,49,3,0,138
"Rutland Town",-,"Elem. School",155,78,1,0,234
"Rutland Town",-,"Town Hall",54,31,1,0,86
Ryegate,,,46,9,5,0,60
Salisbury,,,43,19,0,0,62
Sandgate,,,13,10,0,0,23
Searsburg,,,8,5,1,0,14
Shaftsbury,,,112,70,10,0,192
Sharon,,,19,29,2,0,50
Sheffield,,,27,7,1,0,35
Shelburne,-,"Chittenden 5-1",164,80,9,0,253
Shelburne,-,"Chittenden 5-2",148,58,19,0,225
Sheldon,,,45,18,16,0,79
Shoreham,,,38,28,2,0,68
Shrewsbury,,,39,25,1,0,65
"S. Burlington",-,"Chittenden 3-10",104,50,3,0,157
"S. Burlington",-,"Chittenden 3-7",161,42,8,0,211
"S. Burlington",-,"Chittenden 3-8",218,65,16,0,299
"S. Burlington",-,"Chittenden 3-9",178,71,6,0,255
"S. Hero",,,108,53,15,0,176
Springfield,-,"Windsor 1-1",2,1,0,0,3
Springfield,-,"Windsor 1-2",155,122,6,0,283
"St. Albans City",,,145,66,54,0,265
"St. Albans Town",,,193,82,36,0,311
"St. George",,,23,7,0,0,30
"St. Johnsbury",,,236,100,21,0,357
Stamford,,,22,8,0,0,30
Stannard,,,10,4,0,0,14
Starksboro,,,44,20,1,0,65
Stockbridge,,,19,18,0,0,37
Stowe,,,172,78,8,0,258
Strafford,,,38,0,3,0,41
Stratton,,,8,1,0,0,9
Sudbury,,,24,8,0,0,32
Sunderland,,,18,16,0,0,34
Sutton,,,42,8,2,0,52
Swanton,,,243,98,37,0,378
Thetford,,,35,37,3,0,75
Tinmouth,,,20,12,0,0,32
Topsham,,,55,22,2,0,79
Townshend,,,22,16,3,0,41
Troy,,,21,7,3,0,31
Tunbridge,,,60,35,7,0,102
Underhill,,,130,45,4,0,179
Vergennes,,,109,38,41,0,188
Vernon,,,94,29,5,0,128
Vershire,,,18,19,1,0,38
Victory,,,3,3,0,0,6
Waitsfield,,,62,26,2,0,90
Walden,,,33,14,2,0,49
Wallingford,,,57,32,1,0,90
Waltham,,,22,15,1,0,38
Wardsboro,,,16,7,1,0,24
Warren,,,41,34,1,0,76
Washington,,,38,25,2,0,65
Waterbury,,,149,43,7,0,199
Waterford,,,69,29,1,0,99
Waterville,,,32,5,0,0,37
Weathersfield,,,47,43,3,0,93
Wells,,,22,15,0,0,37
"W. Fairlee",,,11,12,0,0,23
"W. Haven",,,8,8,1,0,17
"W. Rutland",,,62,36,2,0,100
"W. Windsor",,,33,23,3,0,59
Westfield,,,20,13,8,0,41
Westford,,,58,24,3,0,85
Westminster,-,"Windham 4",1,1,0,0,2
Westminster,-,"Windham 5",36,24,5,0,65
Westmore,,,8,7,1,0,16
Weston,,,15,9,0,0,24
Weybridge,,,31,25,2,0,58
Wheelock,,,27,14,1,0,42
Whiting,,,16,9,2,0,27
Whitingham,,,22,15,1,0,38
Williamstown,,,118,34,9,0,161
Williston,,,357,120,4,0,481
Wilmington,,,54,24,0,0,78
Windham,,,6,3,1,0,10
Windsor,,,67,30,1,0,98
Winhall,,,27,14,0,0,41
Winooski,,,117,49,2,0,168
Wolcott,,,45,10,6,0,61
Woodbury,,,56,14,4,0,74
Woodford,,,9,13,0,0,22
Woodstock,,,99,71,5,0,175
Worcester,,,39,14,2,0,55
TOTALS,,,"18,115","8,510","1,345",0,"27,970"
