City/Town,Ward,Pct,"John Macgovern","H. Brooke Paige",Write-Ins,Blanks,"Total Votes Cast"
,,,,
Addison,,,26,8,0,1,35
Albany,,,17,7,2,3,29
Alburgh,,,75,18,0,12,105
Andover,,,18,0,0,0,18
Arlington,,,16,9,0,2,27
Athens,,,8,1,0,2,11
Bakersfield,,,26,5,0,5,36
Baltimore,,,9,1,1,0,11
Barnard,,,26,3,0,1,30
Barnet,,,34,7,0,8,49
"Barre City",,,50,67,4,15,136
"Barre Town",,,57,116,2,12,187
Barton,,,15,7,6,7,35
Belvidere,,,5,4,0,0,9
Bennington,-,"Bennington 2-1",25,5,0,1,31
Bennington,-,"Bennington 2-2",19,8,1,15,43
Benson,,,18,4,0,1,23
Berkshire,,,49,7,1,16,73
Berlin,,,27,29,6,13,75
Bethel,,,18,1,1,2,22
Bloomfield,,,1,0,0,0,1
Bolton,,,6,5,3,0,14
Bradford,,,29,6,1,2,38
Braintree,,,11,2,0,2,15
Brandon,,,59,17,1,15,92
Brattleboro,-,"Windham 2-1",31,4,0,6,41
Brattleboro,-,"Windham 2-2",28,1,0,1,30
Brattleboro,-,"Windham 2-3",17,1,0,2,20
Bridgewater,,,10,0,0,1,11
Bridport,,,25,8,0,1,34
Brighton,,,18,8,0,7,33
Bristol,,,41,5,0,3,49
Brookfield,,,4,1,0,0,5
Brookline,,,13,1,0,0,14
Brownington,,,6,4,2,4,16
Brunswick,,,3,3,1,4,11
Burke,,,16,6,2,4,28
Burlington,-,"Chittenden 6-1",97,25,1,8,131
Burlington,-,"Chittenden 6-2",13,7,1,1,22
Burlington,-,"Chittenden 6-3",15,7,3,1,26
Burlington,-,"Chittenden 6-4",9,6,0,4,19
Burlington,-,"Chittenden 6-5",29,4,1,8,42
Burlington,-,"Chittenden 6-6",3,1,0,1,5
Burlington,-,"Chittenden 6-7",0,0,0,0,0
Cabot,,,7,5,0,2,14
Calais,,,13,7,0,2,22
Cambridge,,,28,13,2,5,48
Canaan,,,22,2,1,3,28
Castleton,,,37,6,1,5,49
Cavendish,,,37,7,1,9,54
Charleston,,,20,7,0,0,27
Charlotte,,,25,4,1,7,37
Chelsea,,,17,17,0,3,37
Chester,,,44,5,1,0,50
Chittenden,,,13,1,0,3,17
Clarendon,,,27,4,0,0,31
Colchester,-,"Chittenden 9-1",41,14,2,5,62
Colchester,-,"Chittenden 9-2",55,23,1,10,89
Concord,,,106,17,11,52,186
Corinth,,,13,8,0,5,26
Cornwall,,,9,3,0,1,13
Coventry,,,13,5,5,7,30
Craftsbury,,,14,4,1,7,26
Danby,,,69,22,1,17,109
Danville,,,15,12,0,6,33
Derby,,,30,15,8,13,66
Dorset,,,16,9,0,3,28
Dover,,,42,8,0,7,57
Dummerston,,,19,2,1,1,23
Duxbury,,,8,8,0,3,19
"E. Haven",,,5,2,0,0,7
"E. Montpelier",,,16,25,1,4,46
Eden,,,9,1,0,2,12
Elmore,,,8,2,1,2,13
Enosburgh,,,46,6,7,20,79
Essex,-,"Chittenden 8-1",53,16,0,9,78
Essex,-,"Chittenden 8-2",52,14,1,10,77
Essex,-,"Chittenden 8-3",15,5,0,6,26
"Fair Haven",,,31,9,3,10,53
Fairfax,,,68,17,2,25,112
Fairfield,,,14,5,4,9,32
Fairlee,,,16,2,1,3,22
Fayston,,,4,6,0,2,12
Ferrisburgh,,,25,6,0,1,32
Fletcher,,,7,4,0,5,16
Franklin,,,30,9,14,21,74
Georgia,,,91,25,2,30,148
Glover,,,11,13,1,2,27
Goshen,,,8,3,0,0,11
Grafton,,,23,1,0,3,27
Granby,,,12,3,1,3,19
"Grand Isle",,,26,9,0,3,38
Granville,,,2,0,0,0,2
Greensboro,,,8,4,0,1,13
Groton,,,10,12,3,1,26
Guildhall,,,24,9,2,13,48
Guilford,,,14,1,2,2,19
Halifax,,,12,3,0,2,17
Hancock,,,2,0,0,0,2
Hardwick,,,12,4,0,3,19
Hartford,-,"Windsor 4-1",14,0,0,0,14
Hartford,-,"Windsor 4-2",52,3,3,6,64
Hartland,,,46,1,2,0,49
Highgate,,,85,27,5,26,143
Hinesburg,-,"Chittenden 4-1",0,0,0,0,0
Hinesburg,-,"Chittenden 4-2",24,6,0,1,31
Holland,,,4,3,3,1,11
Hubbardton,,,11,3,0,2,16
Huntington,,,15,3,0,2,20
"Hyde Park",,,20,11,1,5,37
Ira,,,10,2,0,0,12
Irasburg,,,14,2,4,6,26
"Isle La Motte",,,4,3,0,2,9
Jamaica,,,7,1,0,2,10
Jay,,,8,1,0,1,10
Jericho,,,65,15,1,10,91
Johnson,,,16,5,2,12,35
Killington,,,10,3,0,3,16
Kirby,,,25,6,0,9,40
Landgrove,,,1,0,0,2,3
Leicester,,,11,3,1,1,16
Lemington,,,2,0,0,3,5
Lincoln,,,14,7,0,3,24
Londonderry,,,9,4,0,2,15
Lowell,,,12,7,1,7,27
Ludlow,,,29,2,0,2,33
Lunenburg,,,92,32,16,40,180
Lyndon,,,68,15,4,10,97
Maidstone,,,10,2,4,4,20
Manchester,,,42,9,0,3,54
Marlboro,,,8,1,0,1,10
Marshfield,,,10,3,1,3,17
Mendon,,,15,5,1,2,23
Middlebury,,,31,13,0,5,49
Middlesex,,,8,13,1,6,28
"Middletown Springs",,,14,4,1,2,21
Milton,-,"Chittenden 10",116,42,3,276,437
Milton,-,"Grand Isle-Chittenden",20,6,2,2,30
Monkton,,,11,4,0,1,16
Montgomery,,,12,5,0,1,18
Montpelier,,,31,29,2,15,77
Moretown,,,12,15,0,3,30
Morgan,,,12,6,0,4,22
Morristown,,,40,23,4,6,73
"Mount Holly",,,27,4,0,0,31
"Mount Tabor",,,1,0,0,0,1
"New Haven",,,27,6,1,2,36
Newark,,,9,0,0,7,16
Newbury,,,33,9,0,8,50
Newfane,,,11,5,0,3,19
"Newport City",,,34,18,10,17,79
"Newport Town",,,8,3,2,4,17
"N. Hero",,,15,3,0,5,23
Northfield,,,19,30,0,10,59
Norton,,,6,3,2,1,12
Norwich,,,29,5,0,3,37
Orange,,,16,10,0,2,28
Orwell,,,27,6,2,2,37
Panton,,,11,2,1,0,14
Pawlet,,,15,5,1,2,23
Peacham,,,8,7,1,1,17
Peru,,,11,1,0,4,16
Pittsfield,,,3,0,0,2,5
Pittsford,,,32,7,1,16,56
Plainfield,,,3,6,1,0,10
Plymouth,,,16,1,1,1,19
Pomfret,,,13,2,0,0,15
Poultney,,,23,16,0,1,40
Pownal,,,20,4,0,2,26
Proctor,,,9,4,0,0,13
Putney,,,14,3,0,1,18
Randolph,,,40,14,1,1,56
Reading,,,7,0,1,2,10
Readsboro,,,14,2,0,1,17
Richford,,,16,13,3,6,38
Richmond,,,34,17,0,8,59
Ripton,,,6,3,0,0,9
Rochester,,,13,3,1,2,19
Rockingham,,,36,11,2,3,52
Roxbury,,,3,5,2,0,10
Royalton,,,26,5,1,9,41
Rupert,,,10,1,0,1,12
"Rutland City",-,"Rutland 5-1",37,5,0,14,56
"Rutland City",-,"Rutland 5-2",37,11,0,13,61
"Rutland City",-,"Rutland 5-3",15,2,0,9,26
"Rutland City",-,"Rutland 5-4",32,6,0,13,51
"Rutland Town",,,91,19,2,30,142
Ryegate,,,9,4,1,3,17
Salisbury,,,5,5,0,1,11
Sandgate,,,4,1,0,1,6
Searsburg,,,3,0,0,0,3
Shaftsbury,,,23,7,1,2,33
Sharon,,,23,1,0,3,27
Sheffield,,,5,4,1,2,12
Shelburne,-,"Chittenden 5-1",68,16,0,10,94
Shelburne,-,"Chittenden 5-2",52,11,1,6,70
Sheldon,,,24,7,5,10,46
Shoreham,,,12,2,0,1,15
Shrewsbury,,,19,6,0,3,28
"S. Burlington",-,"Chittenden 7-1",35,7,0,8,50
"S. Burlington",-,"Chittenden 7-2",53,21,3,6,83
"S. Burlington",-,"Chittenden 7-3",32,15,0,5,52
"S. Burlington",-,"Chittenden 7-4",53,20,3,3,79
"S. Hero",,,28,7,0,3,38
Springfield,-,"Windsor 3-1",1,0,1,0,2
Springfield,-,"Windsor 3-2",77,6,0,1,84
"St. Albans City",,,168,47,31,63,309
"St. Albans Town",-,"Franklin 3-1",83,17,3,20,123
"St. Albans Town",-,"Franklin 3-2",121,43,14,32,210
"St. George",,,3,2,1,2,8
"St. Johnsbury",,,50,17,3,13,83
Stamford,,,9,2,0,0,11
Stannard,,,1,1,0,0,2
Starksboro,,,21,8,1,2,32
Stockbridge,,,12,1,0,1,14
Stowe,,,26,8,2,0,36
Strafford,,,11,3,0,2,16
Stratton,,,4,0,0,0,4
Sudbury,,,13,1,0,5,19
Sunderland,-,"Bennington 3",0,0,0,0,0
Sunderland,-,"Bennington 4",2,2,0,3,7
Sutton,,,11,2,1,5,19
Swanton,,,166,29,6,40,241
Thetford,,,7,6,1,1,15
Tinmouth,-,"Rutland 2",2,0,0,0,2
Tinmouth,-,Rutland-Bennington,4,3,0,1,8
Topsham,,,13,11,2,2,28
Townshend,,,14,5,0,2,21
Troy,-,"Orleans 2",6,0,2,1,9
Troy,-,Orleans-Lamoille,2,3,0,5,10
Tunbridge,,,17,8,0,3,28
Underhill,,,30,13,0,3,46
Vergennes,,,21,2,0,5,28
Vernon,,,44,6,1,10,61
Vershire,,,3,6,0,1,10
Victory,,,5,2,0,3,10
Waitsfield,,,15,10,0,2,27
Walden,,,13,4,0,2,19
Wallingford,,,30,5,0,2,37
Waltham,,,0,0,0,2,2
Wardsboro,,,9,1,0,1,11
Warren,,,4,6,1,4,15
Washington,,,4,22,1,1,28
Waterbury,,,20,20,0,9,49
Waterford,,,12,3,0,4,19
Waterville,,,6,1,0,3,10
Weathersfield,,,38,2,2,1,43
Wells,,,12,0,0,1,13
"W. Fairlee",,,2,3,0,1,6
"W. Haven",,,4,3,0,0,7
"W. Rutland",,,24,6,0,2,32
"W. Windsor",,,19,0,2,0,21
Westfield,,,9,2,1,3,15
Westford,,,15,3,1,0,19
Westminster,-,"Windham 3",0,1,0,0,1
Westminster,-,"Windham 4",22,6,1,2,31
Westmore,,,4,2,0,3,9
Weston,,,16,0,0,2,18
Weybridge,,,7,3,0,1,11
Wheelock,,,11,1,1,2,15
Whiting,,,10,4,0,2,16
Whitingham,-,"Windham 6",16,3,0,0,19
Whitingham,-,Windham-Bennington,0,2,0,0,2
Williamstown,,,29,26,4,8,67
Williston,,,75,24,4,12,115
Wilmington,,,24,4,0,1,29
Windham,,,5,1,0,0,6
Windsor,,,40,2,1,0,43
Winhall,,,11,3,1,2,17
Winooski,,,33,4,3,4,44
Wolcott,,,8,7,2,5,22
Woodbury,,,14,9,0,4,27
Woodford,,,1,0,0,0,1
Woodstock,,,62,5,2,2,71
Worcester,,,6,3,0,1,10
TOTALS,,,"6,358","2,084",331,"1,639","10,412"
