City/Town,Ward,Pct,"William H. Sorrell","H. Brooke Paige",Write-Ins,Blanks,"Total Votes Cast"
,,,,
Addison,,,29,6,0,2,37
Albany,,,17,3,0,0,20
Alburgh,,,126,25,2,28,181
Andover,,,9,3,0,6,18
Arlington,,,25,13,1,4,43
Athens,,,10,1,0,6,17
Bakersfield,,,21,9,0,2,32
Baltimore,,,2,0,0,1,3
Barnard,,,17,5,0,3,25
Barnet,,,32,11,0,3,46
"Barre City",,,104,36,4,18,162
"Barre Town",,,52,18,3,2,75
Barton,,,19,7,1,2,29
Belvidere,,,7,1,0,1,9
Bennington,-,"Bennington 2-1",551,146,3,283,983
Bennington,-,"Bennington 2-2",264,94,2,92,452
Benson,,,13,2,0,3,18
Berkshire,,,15,9,0,5,29
Berlin,,,36,18,0,11,65
Bethel,,,29,2,0,2,33
Bloomfield,,,4,2,0,1,7
Bolton,,,14,7,0,1,22
Bradford,,,21,5,0,3,29
Braintree,,,10,1,0,0,11
Brandon,,,273,70,2,54,399
Brattleboro,-,"Windham 2-1",202,37,2,50,291
Brattleboro,-,"Windham 2-2",226,47,1,70,344
Brattleboro,-,"Windham 2-3",281,50,2,70,403
Bridgewater,,,9,6,1,1,17
Bridport,,,10,1,0,4,15
Brighton,,,20,4,0,16,40
Bristol,,,41,6,0,5,52
Brookfield,,,24,4,0,4,32
Brookline,,,33,12,0,18,63
Brownington,,,28,15,0,9,52
Brunswick,,,7,1,0,2,10
Burke,,,7,2,0,1,10
Burlington,-,"Chittenden 6-1",395,59,5,56,515
Burlington,-,"Chittenden 6-2",263,34,7,40,344
Burlington,-,"Chittenden 6-3",113,24,3,20,160
Burlington,-,"Chittenden 6-4",135,13,1,24,173
Burlington,-,"Chittenden 6-5",332,60,12,56,460
Burlington,-,"Chittenden 6-6",37,6,1,6,50
Burlington,-,"Chittenden 6-7",4,0,0,2,6
Cabot,,,19,10,0,4,33
Calais,,,36,6,0,11,53
Cambridge,,,46,17,2,9,74
Canaan,,,3,4,0,0,7
Castleton,,,35,12,0,3,50
Cavendish,,,54,21,0,20,95
Charleston,,,11,6,0,5,22
Charlotte,,,152,28,0,40,220
Chelsea,,,19,8,0,3,30
Chester,,,50,14,0,8,72
Chittenden,,,19,5,0,4,28
Clarendon,,,22,5,0,3,30
Colchester,-,"Chittenden 9-1",82,13,0,6,101
Colchester,-,"Chittenden 9-2",113,30,0,15,158
Concord,,,18,4,1,1,24
Corinth,,,33,6,0,0,39
Cornwall,,,44,5,0,6,55
Coventry,,,14,4,0,2,20
Craftsbury,,,42,5,3,9,59
Danby,,,32,17,0,6,55
Danville,,,49,17,0,9,75
Derby,,,133,37,0,17,187
Dorset,,,80,17,1,28,126
Dover,,,23,11,0,13,47
Dummerston,,,164,21,0,44,229
Duxbury,,,16,2,1,4,23
"E. Haven",,,9,3,0,0,12
"E. Montpelier",,,51,7,1,8,67
Eden,,,11,1,0,1,13
Elmore,,,23,4,0,6,33
Enosburgh,,,51,7,1,16,75
Essex,-,"Chittenden 8-1",86,6,2,12,106
Essex,-,"Chittenden 8-2",92,17,4,8,121
Essex,-,"Chittenden 8-3",28,3,0,3,34
"Fair Haven",,,25,10,0,5,40
Fairfax,,,53,15,1,8,77
Fairfield,,,38,9,0,3,50
Fairlee,,,13,4,1,4,22
Fayston,,,18,6,0,1,25
Ferrisburgh,,,35,8,0,1,44
Fletcher,,,13,5,0,1,19
Franklin,,,37,12,0,6,55
Georgia,,,20,6,1,2,29
Glover,,,37,9,2,5,53
Goshen,,,9,3,0,0,12
Grafton,,,29,11,0,24,64
Granby,,,2,1,0,0,3
"Grand Isle",,,177,39,2,28,246
Granville,,,12,1,0,0,13
Greensboro,,,42,7,1,12,62
Groton,,,9,6,0,2,17
Guildhall,,,4,3,0,1,8
Guilford,,,102,19,1,34,156
Halifax,,,18,5,0,5,28
Hancock,,,8,3,0,1,12
Hardwick,,,32,14,0,6,52
Hartford,-,"Windsor 4-1",15,6,0,5,26
Hartford,-,"Windsor 4-2",76,22,1,17,116
Hartland,,,56,11,0,7,74
Highgate,,,34,9,1,5,49
Hinesburg,-,"Chittenden 4-1",2,0,0,0,2
Hinesburg,-,"Chittenden 4-2",82,14,2,15,113
Holland,,,6,2,0,0,8
Hubbardton,,,2,0,0,2,4
Huntington,,,69,7,2,7,85
"Hyde Park",,,55,7,1,20,83
Ira,,,7,4,0,1,12
Irasburg,,,6,4,0,3,13
"Isle La Motte",,,41,15,0,8,64
Jamaica,,,33,11,1,14,59
Jay,,,4,1,0,1,6
Jericho,,,100,17,0,13,130
Johnson,,,38,10,2,4,54
Killington,,,12,1,0,2,15
Kirby,,,1,0,0,0,1
Landgrove,,,10,1,0,2,13
Leicester,,,13,1,0,1,15
Lemington,,,0,2,0,0,2
Lincoln,,,38,7,0,4,49
Londonderry,,,17,11,0,9,37
Lowell,,,15,5,0,4,24
Ludlow,,,12,8,0,1,21
Lunenburg,,,8,6,0,0,14
Lyndon,,,34,7,0,3,44
Maidstone,,,4,0,0,0,4
Manchester,,,60,12,0,11,83
Marlboro,,,97,20,4,29,150
Marshfield,,,26,9,0,7,42
Mendon,,,16,1,0,2,19
Middlebury,,,480,84,1,108,673
Middlesex,,,40,7,1,10,58
"Middletown Springs",,,25,6,0,4,35
Milton,-,"Chittenden 10",74,21,2,8,105
Milton,-,"Grand Isle-Chittenden",21,0,0,0,21
Monkton,,,38,6,0,4,48
Montgomery,,,37,6,1,7,51
Montpelier,,,270,60,7,55,392
Moretown,,,15,5,1,9,30
Morgan,,,8,3,1,1,13
Morristown,,,99,23,1,15,138
"Mount Holly",,,24,3,0,4,31
"Mount Tabor",,,6,1,0,0,7
"New Haven",,,35,3,0,0,38
Newark,,,6,3,0,0,9
Newbury,,,24,11,0,6,41
Newfane,,,113,17,2,36,168
"Newport City",,,53,17,0,6,76
"Newport Town",,,12,10,1,1,24
"N. Hero",,,88,23,0,18,129
Northfield,,,31,18,0,4,53
Norton,,,3,1,0,4,8
Norwich,,,468,148,2,195,813
Orange,,,10,2,0,2,14
Orwell,,,19,8,0,2,29
Panton,,,15,0,0,2,17
Pawlet,,,29,6,0,4,39
Peacham,,,38,9,0,4,51
Peru,,,14,5,0,6,25
Pittsfield,,,9,3,0,4,16
Pittsford,,,30,7,0,2,39
Plainfield,,,30,9,0,2,41
Plymouth,,,5,0,0,0,5
Pomfret,,,30,3,2,5,40
Poultney,,,27,12,0,4,43
Pownal,,,85,16,2,27,130
Proctor,,,21,5,0,3,29
Putney,,,166,32,0,50,248
Randolph,,,57,19,2,3,81
Reading,,,19,5,0,3,27
Readsboro,,,15,2,0,1,18
Richford,,,16,7,0,4,27
Richmond,,,122,17,0,16,155
Ripton,,,38,9,1,10,58
Rochester,,,25,10,0,6,41
Rockingham,,,249,70,2,74,395
Roxbury,,,13,2,0,2,17
Royalton,,,16,6,0,3,25
Rupert,,,22,5,0,5,32
"Rutland City",-,"Rutland 5-1",53,17,1,17,88
"Rutland City",-,"Rutland 5-2",37,15,1,9,62
"Rutland City",-,"Rutland 5-3",25,4,3,7,39
"Rutland City",-,"Rutland 5-4",38,7,0,6,51
"Rutland Town",,,49,15,1,13,78
Ryegate,,,18,2,0,3,23
Salisbury,,,0,19,0,4,23
Sandgate,,,17,3,0,1,21
Searsburg,,,2,0,0,0,2
Shaftsbury,,,55,6,1,12,74
Sharon,,,80,21,0,19,120
Sheffield,,,4,3,0,5,12
Shelburne,-,"Chittenden 5-1",194,35,0,26,255
Shelburne,-,"Chittenden 5-2",76,7,1,18,102
Sheldon,,,14,5,0,1,20
Shoreham,,,56,11,0,15,82
Shrewsbury,,,40,5,0,4,49
"S. Burlington",-,"Chittenden 7-1",123,20,0,25,168
"S. Burlington",-,"Chittenden 7-2",110,11,0,8,129
"S. Burlington",-,"Chittenden 7-3",98,18,1,11,128
"S. Burlington",-,"Chittenden 7-4",119,21,1,21,162
"S. Hero",,,193,25,1,30,249
Springfield,-,"Windsor 3-1",0,2,0,0,2
Springfield,-,"Windsor 3-2",83,23,0,13,119
"St. Albans City",,,132,27,1,11,171
"St. Albans Town",-,"Franklin 3-1",27,9,0,4,40
"St. Albans Town",-,"Franklin 3-2",86,16,0,8,110
"St. George",,,6,0,0,0,6
"St. Johnsbury",,,64,25,0,11,100
Stamford,,,9,4,0,5,18
Stannard,,,12,7,0,8,27
Starksboro,,,28,5,0,4,37
Stockbridge,,,6,1,0,1,8
Stowe,,,53,15,0,19,87
Strafford,,,130,47,1,43,221
Stratton,,,2,1,0,4,7
Sudbury,,,6,1,0,1,8
Sunderland,-,"Bennington 3",5,1,0,1,7
Sunderland,-,"Bennington 4",4,1,0,1,6
Sutton,,,7,0,0,0,7
Swanton,,,56,11,1,8,76
Thetford,,,346,108,1,147,602
Tinmouth,-,"Rutland 2",4,0,0,0,4
Tinmouth,-,Rutland-Bennington,13,3,0,0,16
Topsham,,,3,2,0,1,6
Townshend,,,67,22,0,36,125
Troy,-,"Orleans 2",2,0,0,0,2
Troy,-,Orleans-Lamoille,11,3,0,3,17
Tunbridge,,,21,7,1,5,34
Underhill,,,67,16,1,8,92
Vergennes,,,28,9,0,2,39
Vernon,,,34,17,0,18,69
Vershire,,,14,7,0,6,27
Victory,,,1,0,0,0,1
Waitsfield,,,82,13,0,16,111
Walden,,,10,5,0,7,22
Wallingford,,,31,8,0,8,47
Waltham,,,8,0,0,0,8
Wardsboro,,,21,7,2,4,34
Warren,,,22,11,0,8,41
Washington,,,11,5,2,2,20
Waterbury,,,60,11,0,6,77
Waterford,,,8,4,0,2,14
Waterville,,,15,0,1,3,19
Weathersfield,,,214,81,1,47,343
Wells,,,15,6,0,3,24
"W. Fairlee",,,7,5,0,2,14
"W. Haven",,,10,3,1,3,17
"W. Rutland",,,11,5,0,4,20
"W. Windsor",,,21,4,0,1,26
Westfield,,,9,7,2,2,20
Westford,,,42,1,0,11,54
Westminster,-,"Windham 3",6,0,0,2,8
Westminster,-,"Windham 4",217,43,1,52,313
Westmore,,,5,1,0,0,6
Weston,,,15,7,0,1,23
Weybridge,,,34,4,0,2,40
Wheelock,,,9,3,0,1,13
Whiting,,,12,2,0,2,16
Whitingham,-,"Windham 6",24,9,0,7,40
Whitingham,-,Windham-Bennington,1,0,0,0,1
Williamstown,,,33,12,0,3,48
Williston,,,146,10,0,10,166
Wilmington,,,27,8,0,2,37
Windham,,,27,13,0,20,60
Windsor,,,35,12,0,3,50
Winhall,,,3,1,1,4,9
Winooski,,,312,61,1,97,471
Wolcott,,,46,7,0,6,59
Woodbury,,,19,5,0,0,24
Woodford,,,11,2,0,2,15
Woodstock,,,57,23,1,12,93
Worcester,,,31,9,1,7,48
TOTALS,,,"14,734","3,488",152,"3,381","21,755"
