City/Town,Ward,Pct,"Randy Brock",Write-Ins,Blanks,"Total Votes Cast"
,,,
Addison,,,32,0,3,35
Albany,,,22,1,6,29
Alburgh,,,100,0,5,105
Andover,,,18,0,0,18
Arlington,,,26,0,1,27
Athens,,,11,0,0,11
Bakersfield,,,34,0,2,36
Baltimore,,,9,0,1,10
Barnard,,,26,0,4,30
Barnet,,,40,3,6,49
"Barre City",,,131,3,2,136
"Barre Town",,,177,1,9,187
Barton,,,29,2,4,35
Belvidere,,,9,0,0,9
Bennington,-,"Bennington 2-1",28,0,3,31
Bennington,-,"Bennington 2-2",38,0,5,43
Benson,,,23,0,1,24
Berkshire,,,62,3,8,73
Berlin,,,68,2,5,75
Bethel,,,19,1,2,22
Bloomfield,,,1,0,0,1
Bolton,,,14,0,0,14
Bradford,,,36,1,1,38
Braintree,,,15,0,0,15
Brandon,,,81,1,10,92
Brattleboro,-,"Windham 2-1",38,0,3,41
Brattleboro,-,"Windham 2-2",27,1,2,30
Brattleboro,-,"Windham 2-3",19,1,0,20
Bridgewater,,,11,0,0,11
Bridport,,,31,0,3,34
Brighton,,,26,1,6,33
Bristol,,,48,0,1,49
Brookfield,,,5,0,0,5
Brookline,,,13,0,1,14
Brownington,,,13,3,3,19
Brunswick,,,7,2,2,11
Burke,,,27,0,1,28
Burlington,-,"Chittenden 6-1",123,1,7,131
Burlington,-,"Chittenden 6-2",20,1,1,22
Burlington,-,"Chittenden 6-3",24,2,0,26
Burlington,-,"Chittenden 6-4",14,0,5,19
Burlington,-,"Chittenden 6-5",34,0,8,42
Burlington,-,"Chittenden 6-6",3,0,2,5
Burlington,-,"Chittenden 6-7",0,0,0,0
Cabot,,,11,0,3,14
Calais,,,21,0,1,22
Cambridge,,,44,1,3,48
Canaan,,,23,1,4,28
Castleton,,,46,1,2,49
Cavendish,,,45,0,9,54
Charleston,,,25,0,2,27
Charlotte,,,31,1,5,37
Chelsea,,,36,2,2,40
Chester,,,46,1,3,50
Chittenden,,,16,0,1,17
Clarendon,,,30,0,1,31
Colchester,-,"Chittenden 9-1",56,1,5,62
Colchester,-,"Chittenden 9-2",83,0,6,89
Concord,,,131,5,50,186
Corinth,,,23,0,3,26
Cornwall,,,12,0,1,13
Coventry,,,20,4,6,30
Craftsbury,,,26,0,1,27
Danby,,,98,1,11,110
Danville,,,31,0,3,34
Derby,,,59,3,4,66
Dorset,,,28,0,0,28
Dover,,,57,51,6,114
Dummerston,,,22,0,1,23
Duxbury,,,19,0,0,19
"E. Haven",,,6,0,1,7
"E. Montpelier",,,40,1,5,46
Eden,,,10,0,2,12
Elmore,,,10,0,3,13
Enosburgh,,,68,2,9,79
Essex,-,"Chittenden 8-1",69,0,9,78
Essex,-,"Chittenden 8-2",70,2,5,77
Essex,-,"Chittenden 8-3",22,0,4,26
"Fair Haven",,,51,0,2,53
Fairfax,,,101,0,11,112
Fairfield,,,25,4,4,33
Fairlee,,,17,1,4,22
Fayston,,,11,0,1,12
Ferrisburgh,,,31,0,1,32
Fletcher,,,13,0,3,16
Franklin,,,64,5,5,74
Georgia,,,130,2,16,148
Glover,,,24,0,3,27
Goshen,,,11,0,0,11
Grafton,,,25,0,2,27
Granby,,,15,1,3,19
"Grand Isle",,,35,1,2,38
Granville,,,2,0,0,2
Greensboro,,,13,0,0,13
Groton,,,26,0,0,26
Guildhall,,,33,1,14,48
Guilford,,,18,1,0,19
Halifax,,,16,0,1,17
Hancock,,,2,0,0,2
Hardwick,,,18,1,0,19
Hartford,-,"Windsor 4-1",13,0,1,14
Hartford,-,"Windsor 4-2",55,3,6,64
Hartland,,,45,2,3,50
Highgate,,,126,3,8,137
Hinesburg,-,"Chittenden 4-1",0,0,0,0
Hinesburg,-,"Chittenden 4-2",27,0,4,31
Holland,,,8,1,2,11
Hubbardton,,,16,0,0,16
Huntington,,,17,0,3,20
"Hyde Park",,,33,1,3,37
Ira,,,12,0,0,12
Irasburg,,,23,0,3,26
"Isle La Motte",,,8,1,0,9
Jamaica,,,10,0,0,10
Jay,,,10,0,0,10
Jericho,,,80,1,10,91
Johnson,,,21,1,13,35
Killington,,,14,0,2,16
Kirby,,,29,0,11,40
Landgrove,,,1,0,1,2
Leicester,,,15,0,1,16
Lemington,,,2,0,3,5
Lincoln,,,24,0,0,24
Londonderry,,,14,0,1,15
Lowell,,,18,4,5,27
Ludlow,,,32,0,1,33
Lunenburg,,,146,5,29,180
Lyndon,,,86,5,6,97
Maidstone,,,16,1,3,20
Manchester,,,54,0,0,54
Marlboro,,,9,0,1,10
Marshfield,,,16,0,1,17
Mendon,,,18,0,5,23
Middlebury,,,46,0,3,49
Middlesex,,,23,1,4,28
"Middletown Springs",,,18,0,3,21
Milton,-,"Chittenden 10",161,3,273,437
Milton,-,"Grand Isle-Chittenden",27,1,0,28
Monkton,,,15,0,1,16
Montgomery,,,17,0,1,18
Montpelier,,,65,1,11,77
Moretown,,,28,1,1,30
Morgan,,,22,0,1,23
Morristown,,,68,2,3,73
"Mount Holly",,,29,0,6,35
"Mount Tabor",,,1,0,0,1
"New Haven",,,33,2,1,36
Newark,,,14,0,2,16
Newbury,,,45,0,5,50
Newfane,,,19,0,0,19
"Newport City",,,65,5,10,80
"Newport Town",,,10,3,4,17
"N. Hero",,,22,0,1,23
Northfield,,,53,0,6,59
Norton,,,11,1,0,12
Norwich,,,31,0,6,37
Orange,,,27,0,1,28
Orwell,,,36,0,1,37
Panton,,,14,0,0,14
Pawlet,,,22,0,1,23
Peacham,,,17,0,0,17
Peru,,,15,0,1,16
Pittsfield,,,4,0,1,5
Pittsford,,,45,0,11,56
Plainfield,,,9,1,0,10
Plymouth,,,18,0,2,20
Pomfret,,,14,0,1,15
Poultney,,,40,0,0,40
Pownal,,,24,0,2,26
Proctor,,,12,1,0,13
Putney,,,18,0,0,18
Randolph,,,56,0,0,56
Reading,,,10,0,0,10
Readsboro,,,15,0,2,17
Richford,,,34,0,4,38
Richmond,,,55,0,4,59
Ripton,,,9,0,0,9
Rochester,,,17,0,2,19
Rockingham,,,51,0,1,52
Roxbury,,,10,0,0,10
Royalton,,,34,0,7,41
Rupert,,,10,0,3,13
"Rutland City",-,"Rutland 5-1",49,1,6,56
"Rutland City",-,"Rutland 5-2",57,0,4,61
"Rutland City",-,"Rutland 5-3",22,1,10,33
"Rutland City",-,"Rutland 5-4",45,0,6,51
"Rutland Town",,,123,1,18,142
Ryegate,,,17,0,0,17
Salisbury,,,11,0,0,11
Sandgate,,,5,0,1,6
Searsburg,,,1,0,2,3
Shaftsbury,,,30,1,2,33
Sharon,,,24,0,3,27
Sheffield,,,12,0,0,12
Shelburne,-,"Chittenden 5-1",89,1,6,96
Shelburne,-,"Chittenden 5-2",66,0,4,70
Sheldon,,,43,0,3,46
Shoreham,,,15,0,0,15
Shrewsbury,,,23,0,5,28
"S. Burlington",-,"Chittenden 7-1",43,2,5,50
"S. Burlington",-,"Chittenden 7-2",73,3,7,83
"S. Burlington",-,"Chittenden 7-3",47,2,3,52
"S. Burlington",-,"Chittenden 7-4",72,1,6,79
"S. Hero",,,36,0,2,38
Springfield,-,"Windsor 3-1",2,0,0,2
Springfield,-,"Windsor 3-2",80,1,3,84
"St. Albans City",,,263,14,32,309
"St. Albans Town",-,"Franklin 3-1",105,3,15,123
"St. Albans Town",-,"Franklin 3-2",191,6,13,210
"St. George",,,6,0,2,8
"St. Johnsbury",,,77,2,4,83
Stamford,,,11,0,0,11
Stannard,,,2,0,0,2
Starksboro,,,31,0,1,32
Stockbridge,,,13,0,1,14
Stowe,,,37,0,1,38
Strafford,,,15,0,1,16
Stratton,,,4,0,0,4
Sudbury,,,16,0,3,19
Sunderland,-,"Bennington 3",0,0,0,0
Sunderland,-,"Bennington 4",6,0,1,7
Sutton,,,17,1,1,19
Swanton,,,231,3,7,241
Thetford,,,14,1,0,15
Tinmouth,-,"Rutland 2",2,0,0,2
Tinmouth,-,Rutland-Bennington,7,0,1,8
Topsham,,,28,0,0,28
Townshend,,,21,0,0,21
Troy,-,"Orleans 2",8,0,1,9
Troy,-,Orleans-Lamoille,8,1,1,10
Tunbridge,,,28,0,1,29
Underhill,,,45,0,1,46
Vergennes,,,22,1,5,28
Vernon,,,57,1,3,61
Vershire,,,9,0,1,10
Victory,,,8,0,2,10
Waitsfield,,,24,0,3,27
Walden,,,19,0,0,19
Wallingford,,,32,1,4,37
Waltham,,,0,0,2,2
Wardsboro,,,10,0,1,11
Warren,,,13,0,3,16
Washington,,,22,0,6,28
Waterbury,,,48,0,1,49
Waterford,,,18,0,1,19
Waterville,,,8,0,2,10
Weathersfield,,,41,0,2,43
Wells,,,12,0,1,13
"W. Fairlee",,,5,0,1,6
"W. Haven",,,6,0,1,7
"W. Rutland",,,29,1,2,32
"W. Windsor",,,17,1,3,21
Westfield,,,12,2,1,15
Westford,,,18,0,1,19
Westminster,-,"Windham 3",1,0,0,1
Westminster,-,"Windham 4",31,0,0,31
Westmore,,,5,1,3,9
Weston,,,16,0,2,18
Weybridge,,,7,0,4,11
Wheelock,,,13,0,2,15
Whiting,,,15,0,1,16
Whitingham,-,"Windham 6",18,0,1,19
Whitingham,-,Windham-Bennington,2,0,0,2
Williamstown,,,63,3,1,67
Williston,,,100,3,12,115
Wilmington,,,25,0,4,29
Windham,,,5,0,1,6
Windsor,,,37,1,4,42
Winhall,,,15,0,2,17
Winooski,,,38,2,4,44
Wolcott,,,17,1,3,21
Woodbury,,,22,1,4,27
Woodford,,,1,0,0,1
Woodstock,,,60,1,10,71
Worcester,,,7,0,3,10
TOTALS,,,"9,083",239,"1,168","10,490"
