City/Town,Ward,Pct,"Rich Tarrant","Greg Parke","Eric Ericson",Write-Ins,Blanks,"Total Votes Cast"
,,,,,
Addison,,,78,68,6,3,0,155
Albany,,,40,23,6,4,0,73
Alburgh,,,81,40,10,5,0,136
Andover,,,29,7,7,0,0,43
Arlington,,,116,25,7,1,0,149
Athens,,,9,3,0,1,0,13
Bakersfield,,,36,24,1,6,0,67
Baltimore,,,8,3,2,2,0,15
Barnard,,,44,13,6,0,0,63
Barnet,,,90,35,3,3,0,131
"Barre City",-,"Washington 3-1",194,103,13,21,0,331
"Barre City",-,"Washington 3-2",122,101,14,15,0,252
"Barre City",-,"Washington 3-3",15,17,1,4,0,37
"Barre Town",,,491,221,25,58,0,795
Barton,,,119,40,5,26,0,190
Belvidere,,,16,8,3,0,0,27
Bennington,-,"Bennington 2-1",204,35,14,12,0,265
Bennington,-,"Bennington 2-1 Nb",27,10,7,2,0,46
Bennington,-,"Bennington 2-2",203,51,20,6,0,280
Bennington,-,"Bennington 5",7,0,2,0,0,9
Benson,,,26,14,3,3,0,46
Berkshire,,,58,12,0,2,0,72
Berlin,,,103,70,7,5,0,185
Bethel,,,66,26,5,5,0,102
Bloomfield,,,7,1,1,1,0,10
Bolton,,,43,27,1,3,0,74
Bradford,,,92,50,19,13,0,174
Braintree,,,58,27,3,3,0,91
Brandon,,,192,111,10,5,0,318
Brattleboro,-,"Windham 3-1",72,35,8,4,0,119
Brattleboro,-,"Windham 3-2",61,10,5,3,0,79
Brattleboro,-,"Windham 3-3",54,18,10,1,0,83
Bridgewater,,,43,17,2,2,0,64
Bridport,,,87,55,3,7,0,152
Brighton,,,87,27,7,5,0,126
Bristol,,,111,100,8,10,0,229
Brookfield,,,69,32,4,6,0,111
Brookline,,,13,2,5,0,0,20
Brownington,,,30,7,0,1,0,38
Brunswick,,,3,4,3,1,0,11
Burke,,,60,32,7,4,0,103
Burlington,-,"Chittenden 3-1",380,141,11,5,0,537
Burlington,-,"Chittenden 3-2",171,65,10,5,0,251
Burlington,-,"Chittenden 3-3",92,45,8,6,0,151
Burlington,-,"Chittenden 3-4",73,43,12,1,0,129
Burlington,-,"Chittenden 3-5",283,81,16,5,0,385
Burlington,-,"Chittenden 3-6",25,14,2,1,0,42
Cabot,,,35,24,3,7,0,69
Calais,,,63,41,6,0,0,110
Cambridge,,,88,72,10,11,0,181
Canaan,,,32,9,3,10,0,54
Castleton,,,111,65,5,5,0,186
Cavendish,,,51,21,10,1,0,83
Charleston,,,32,14,1,2,0,49
Charlotte,,,181,62,10,2,0,255
Chelsea,,,105,22,6,4,0,137
Chester,,,105,45,22,2,0,174
Chittenden,,,41,37,5,1,0,84
Clarendon,,,77,62,7,0,0,146
Colchester,-,"Chittenden 7-1",211,109,11,4,0,335
Colchester,-,"Chittenden 7-2",441,148,11,6,0,606
Concord,,,39,21,2,1,0,63
Corinth,,,40,21,11,2,0,74
Cornwall,,,47,29,8,3,0,87
Coventry,,,40,32,6,9,0,87
Craftsbury,,,34,36,4,7,0,81
Danby,,,102,42,5,9,0,158
Danville,,,147,50,14,6,0,217
Derby,,,169,62,4,24,0,259
Dorset,,,109,18,9,2,0,138
Dover,,,42,15,5,3,0,65
Dummerston,,,36,9,5,3,0,53
Duxbury,,,31,45,8,4,0,88
"E. Haven",,,32,8,3,3,0,46
"E. Montpelier",,,132,85,13,13,0,243
Eden,,,24,26,12,14,0,76
Elmore,,,23,12,1,4,0,40
Enosburgh,,,57,33,1,2,0,93
Essex,-,"Chittenden 6-1",313,170,23,4,0,510
Essex,-,"Chittenden 6-2",330,181,10,4,0,525
Essex,-,"Chittenden 6-3",83,70,4,0,0,157
"Fair Haven",,,40,41,6,5,0,92
Fairfax,,,133,73,7,2,0,215
Fairfield,,,42,22,1,5,0,70
Fairlee,,,35,15,6,3,0,59
Fayston,,,36,15,3,0,0,54
Ferrisburgh,,,172,93,10,4,0,279
Fletcher,,,25,23,4,1,0,53
Franklin,,,63,32,2,2,0,99
Georgia,,,176,65,12,9,0,262
Glover,,,33,29,5,15,0,82
Goshen,,,15,10,1,1,0,27
Grafton,,,22,6,3,0,0,31
Granby,,,12,4,0,2,0,18
"Grand Isle",,,134,41,8,16,0,199
Granville,,,10,4,0,0,0,14
Greensboro,,,40,12,2,0,0,54
Groton,,,54,25,4,7,0,90
Guildhall,,,30,6,1,1,0,38
Guilford,,,46,10,7,1,0,64
Halifax,,,23,9,2,0,0,34
Hancock,,,8,9,0,2,0,19
Hardwick,,,69,45,1,14,0,129
Hartford,-,"Windsor 6-1",54,12,2,4,0,72
Hartford,-,"Windsor 6-2",148,39,14,10,0,211
Hartland,,,132,25,8,11,0,176
Highgate,,,77,28,2,15,0,122
Hinesburg,-,"Chittenden 1-1",116,72,12,5,0,205
Hinesburg,-,"Chittenden 1-2",4,1,1,0,0,6
Holland,,,28,11,0,6,0,45
Hubbardton,,,22,10,0,2,0,34
Huntington,,,53,45,4,3,0,105
"Hyde Park",,,91,54,4,8,0,157
Ira,-,"Rutland Rutland 1-1",1,0,1,0,0,2
Ira,-,"Rutland Rutland 1-2",9,12,0,0,0,21
Irasburg,,,22,10,2,18,0,52
"Isle La Motte",,,36,17,5,3,0,61
Jamaica,,,22,7,10,9,0,48
Jay,,,26,4,0,5,0,35
Jericho,,,247,154,13,2,0,416
Johnson,,,49,54,2,10,0,115
Killington,,,55,11,0,1,0,67
Kirby,,,15,9,2,2,0,28
Landgrove,,,10,4,4,1,0,19
Leicester,,,34,42,3,3,0,82
Lemington,,,5,1,2,0,0,8
Lincoln,,,55,37,9,14,0,115
Londonderry,,,55,16,6,2,0,79
Lowell,,,22,11,0,4,0,37
Ludlow,,,83,14,4,1,0,102
Lunenburg,,,60,16,4,19,0,99
Lyndon,,,197,63,6,17,0,283
Maidstone,,,10,4,3,4,0,21
Manchester,,,185,36,13,1,0,235
Marlboro,,,22,9,5,1,0,37
Marshfield,,,38,34,5,24,0,101
Mendon,,,64,33,0,1,0,98
Middlebury,,,181,130,20,10,0,341
Middlesex,,,52,55,8,6,0,121
"Middletown Springs",,,30,26,0,1,0,57
Milton,-,"Chittenden 9",271,137,17,5,0,430
Milton,-,"Grand Isle-Chittenden 1-1",56,29,2,0,0,87
Monkton,,,56,55,5,0,0,116
Montgomery,,,22,17,10,0,0,49
Montpelier,,,310,204,46,4,0,564
Moretown,,,58,51,10,7,0,126
Morgan,,,52,21,2,1,0,76
Morristown,,,137,111,11,9,0,268
"Mount Holly",,,46,38,6,0,0,90
"Mount Tabor",,,10,1,0,0,0,11
"New Haven",,,74,56,5,4,0,139
Newark,,,31,13,2,1,0,47
Newbury,-,"Center Town House",45,27,9,2,0,83
Newbury,-,"Town Office",25,9,2,3,0,39
Newbury,-,"West River Village",13,10,5,4,0,32
Newfane,,,41,16,3,2,0,62
"Newport City",,,205,88,9,30,0,332
"Newport Town",,,78,26,3,7,0,114
"N. Hero",,,73,24,0,6,0,103
Northfield,,,229,134,15,13,0,391
Norton,,,10,3,2,3,0,18
Norwich,,,52,20,6,0,0,78
Orange,,,67,33,8,5,0,113
Orwell,,,67,34,3,11,0,115
Panton,,,34,28,0,0,0,62
Pawlet,,,46,14,4,5,0,69
Peacham,,,36,22,10,1,0,69
Peru,,,22,3,5,1,0,31
Pittsfield,,,37,20,1,1,0,59
Pittsford,,,77,75,5,5,0,162
Plainfield,,,38,26,7,1,0,72
Plymouth,,,21,4,5,0,0,30
Pomfret,,,33,9,1,5,0,48
Poultney,,,162,100,12,15,0,289
Pownal,,,98,14,11,0,0,123
Proctor,,,51,46,2,2,0,101
Putney,,,26,11,4,1,0,42
Randolph,,,241,152,45,14,0,452
Reading,,,22,7,1,2,0,32
Readsboro,,,20,5,4,1,0,30
Richford,,,57,24,4,3,0,88
Richmond,,,164,97,9,4,0,274
Ripton,,,10,5,2,1,0,18
Rochester,,,46,22,4,6,0,78
Rockingham,,,82,24,17,5,0,128
Roxbury,,,20,16,3,2,0,41
Royalton,,,62,33,7,2,0,104
Rupert,,,26,4,6,0,0,36
"Rutland City",-,"Rutland 5-1",148,102,4,5,0,259
"Rutland City",-,"Rutland 5-2",126,71,5,3,0,205
"Rutland City",-,"Rutland 5-3",44,42,1,4,0,91
"Rutland City",-,"Rutland 5-4",106,61,3,7,0,177
"Rutland Town",-,"Elem. School",182,84,6,3,0,275
"Rutland Town",-,"Town Hall",82,23,2,1,0,108
Ryegate,,,44,14,6,1,0,65
Salisbury,,,48,30,0,1,0,79
Sandgate,,,25,3,3,0,0,31
Searsburg,,,10,2,0,1,0,13
Shaftsbury,,,174,34,23,14,0,245
Sharon,,,31,17,5,2,0,55
Sheffield,,,14,21,3,4,0,42
Shelburne,-,"Chittenden 5-1",245,75,18,11,0,349
Shelburne,-,"Chittenden 5-2",225,60,8,7,0,300
Sheldon,,,60,16,3,15,0,94
Shoreham,,,51,32,4,7,0,94
Shrewsbury,,,38,37,4,5,0,84
"S. Burlington",-,"Chittenden 3-10",131,70,10,1,0,212
"S. Burlington",-,"Chittenden 3-7",224,75,5,1,0,305
"S. Burlington",-,"Chittenden 3-8",297,97,8,6,0,408
"S. Burlington",-,"Chittenden 3-9",200,122,21,7,0,350
"S. Hero",,,136,77,11,6,0,230
Springfield,-,"Windsor 1-1",0,2,1,0,0,3
Springfield,-,"Windsor 1-2",214,64,39,11,0,328
"St. Albans City",,,203,83,10,30,0,326
"St. Albans Town",,,267,87,13,14,0,381
"St. George",,,17,24,0,0,0,41
"St. Johnsbury",,,293,114,20,25,0,452
Stamford,,,21,4,5,0,0,30
Stannard,,,9,4,0,1,0,14
Starksboro,,,35,35,3,3,0,76
Stockbridge,,,26,13,1,0,0,40
Stowe,,,237,97,9,10,0,353
Strafford,,,30,11,3,2,0,46
Stratton,,,9,3,2,0,0,14
Sudbury,,,23,18,2,1,0,44
Sunderland,,,34,6,3,0,0,43
Sutton,,,44,11,2,7,0,64
Swanton,,,325,104,15,24,0,468
Thetford,,,35,30,6,10,0,81
Tinmouth,,,19,15,4,2,0,40
Topsham,,,34,39,6,5,0,84
Townshend,,,37,8,6,2,0,53
Troy,,,22,21,2,2,0,47
Tunbridge,,,70,24,5,9,0,108
Underhill,,,153,85,13,3,0,254
Vergennes,,,104,84,12,38,0,238
Vernon,,,121,27,7,5,0,160
Vershire,,,34,8,2,1,0,45
Victory,,,7,1,0,1,0,9
Waitsfield,,,74,36,6,0,0,116
Walden,,,32,20,2,2,0,56
Wallingford,,,80,32,3,1,0,116
Waltham,,,21,16,3,2,0,42
Wardsboro,,,21,3,3,2,0,29
Warren,,,61,30,9,2,0,102
Washington,,,43,24,3,4,0,74
Waterbury,,,127,112,14,6,0,259
Waterford,,,85,25,6,2,0,118
Waterville,,,25,16,2,1,0,44
Weathersfield,,,70,27,16,6,0,119
Wells,,,25,16,1,0,0,42
"W. Fairlee",,,17,7,2,0,0,26
"W. Haven",,,9,7,2,1,0,19
"W. Rutland",,,65,48,1,3,0,117
"W. Windsor",,,51,13,2,5,0,71
Westfield,,,22,16,1,7,0,46
Westford,,,67,42,3,0,0,112
Westminster,-,"Windham 4",4,0,0,0,0,4
Westminster,-,"Windham 5",60,13,6,1,0,80
Westmore,,,13,3,1,1,0,18
Weston,,,27,4,0,0,0,31
Weybridge,,,37,34,7,1,0,79
Wheelock,,,27,12,6,1,0,46
Whiting,,,10,13,1,5,0,29
Whitingham,,,47,6,1,1,0,55
Williamstown,,,86,79,4,11,0,180
Williston,,,429,192,21,10,0,652
Wilmington,,,77,14,8,1,0,100
Windham,,,7,0,3,4,0,14
Windsor,,,74,23,14,2,0,113
Winhall,,,44,1,4,0,0,49
Winooski,,,150,84,3,4,0,241
Wolcott,,,33,28,5,8,0,74
Woodbury,,,44,27,3,7,0,81
Woodford,,,13,9,4,0,0,26
Woodstock,,,159,33,16,5,0,213
Worcester,,,30,25,3,3,0,61
TOTALS,,,"22,008","10,479","1,722","1,382",0,"35,591"
